################################
#..............................#
#..@.$.............%...........#
#..............................#
#########################...####
#.........#....................#
#.........#....................#
#.........#################....#
#.........#....................#
#.........#....................#
#.........#........#.###########
#..................#...........#
#..................#######.....#
#..#################...#.#.....#
#..................#.#.#.......#
#......#.#########.#.#.#.#.....#
#......#.#....#....#.#.#.#######
#......#.#....#....#.#.#.#.....#
#......#.#.........#.#.#.#..#..#
#......#.#..########.#.#.#..#..#
#......#.#.........#.#.#.#..#..#
#......#.#.........#.#.#.#..#..#
#......#.########..#.#.#.#..#..#
#......#...........#.#...#..#..#
#......##########..#.######.##.#
#......#...........#.........#.#
#......#.........#############.#
#................#.....#.......#
#......#.........#..^..#..####.#
#......#.......................#
#......#.........#.............#
################################
